[
{
    "level": 1,
    "map": [     
        [ 152, 152, 152, 152, 152, 152, 152, 152, 152, 152, 152, 152, 152, 152, 152, 152, 152],
        [ 15, 15, 15, 15, 15, 15, 15, 15, 15, 15, 15, 15, 15, 15, 15, 15, 15],
        [ 15, 12, 12, 12, 12, 12, 12, 12, 15, 12, 12, 12, 12, 12, 12, 12, 15],
        [ 15, 12, 15, 15, 15, 15, 15, 15, 15, 15, 15, 15, 15, 15, 15, 12, 15],
        [ 15, 12, 15, 12, 12, 12, 12, 12, 12, 12, 12, 12, 12, 12, 15, 12, 15],
        [ 15, 12, 15, 12, 15, 15, 15, 15, 15, 15, 15, 15, 15, 12, 15, 12, 15], 
        [ 15, 15, 15, 15, 15, 12, 12, 12, 15, 12, 12, 12, 15, 15, 15, 15, 15],
        [ 15, 12, 15, 12, 15, 15, 15, 15, 15, 15, 15, 15, 15, 12, 15, 12, 15],
        [ 15, 12, 15, 12, 12, 12, 12, 12, 12, 12, 12, 12, 12, 12, 15, 12, 15],
        [ 15, 12, 15, 15, 15, 15, 15, 15, 15, 15, 15, 15, 15, 15, 15, 12, 15],
        [ 15, 12, 12, 12, 12, 12, 12, 12, 15, 12, 12, 12, 12, 12, 12, 12, 15],
        [ 15, 15, 15, 15, 15, 15, 15, 15, 15, 15, 15, 15, 15, 15, 15, 15, 15],
        [103,103,103,103,103,103,103,103,103,103,103,103,103,103,103,103,103]
    ],
    "numberOfRows": 13,
    "numberOfColumns": 17
},


{
    "level": 2,
    "map": [     
        [ 152, 152, 152, 152, 152, 152, 152, 152, 152, 152, 152, 152, 152, 152, 152, 152, 152],
        [ 15, 15, 15, 15, 15, 15, 15, 15, 15, 15, 15, 15, 15, 15, 15, 15, 15],
        [ 15, 12, 12, 12, 15, 12, 12, 12, 12, 12, 12, 12, 15, 12, 12, 12, 15],
        [ 15, 12, 15, 15, 15, 15, 15, 15, 15, 15, 15, 15, 15, 15, 15, 12, 15],
        [ 15, 12, 15, 12, 15, 12, 15, 12, 15, 12, 15, 12, 15, 12, 15, 12, 15],
        [ 15, 12, 15, 12, 15, 12, 15, 12, 15, 12, 15, 12, 15, 12, 15, 12, 15], 
        [ 15, 15, 15, 26, 15, 12, 15, 12, 15, 12, 15, 12, 15, 26, 15, 15, 15],
        [ 15, 12, 15, 12, 15, 12, 15, 12, 15, 12, 15, 12, 15, 12, 15, 12, 15],
        [ 15, 12, 15, 12, 12, 12, 15, 12, 26, 12, 15, 12, 12, 12, 15, 12, 15],
        [ 15, 12, 15, 15, 15, 15, 15, 15, 15, 15, 15, 15, 15, 15, 15, 12, 15],
        [ 15, 12, 12, 12, 15, 12, 12, 12, 12, 12, 12, 12, 15, 12, 12, 12, 15],
        [ 15, 15, 15, 15, 15, 15, 15, 15, 15, 15, 15, 15, 15, 15, 15, 15, 15],
        [103,103,103,103,103,103,103,103,103,103,103,103,103,103,103,103,103]
    ],
    "numberOfRows": 13,
    "numberOfColumns": 17
},
    
{
    "level": 3,
    "map": [     
        [ 152, 152, 152, 152, 152, 152, 152, 152, 152, 152, 152, 152, 152, 152, 152, 152, 152],
        [ 15, 15, 15, 15, 15, 15, 15, 15, 15, 15, 15, 15, 15, 15, 15, 15, 15],
        [ 15, 12, 12, 12, 15, 12, 12, 12, 15, 12, 12, 12, 15, 12, 12, 12, 15],
        [ 15, 12, 15, 12, 15, 12, 15, 12, 15, 12, 15, 12, 15, 12, 15, 12, 15],
        [ 15, 12, 15, 12, 15, 12, 15, 12, 15, 12, 15, 12, 15, 12, 15, 12, 15],
        [ 15, 12, 15, 12, 15, 12, 15, 12, 15, 12, 15, 12, 15, 12, 15, 12, 15], 
        [ 15, 15, 15, 26, 15, 15, 15, 15, 15, 15, 15, 15, 15, 15, 15, 15, 15],
        [ 15, 12, 15, 12, 15, 12, 15, 12, 15, 12, 15, 12, 15, 12, 15, 12, 15],
        [ 15, 12, 15, 12, 15, 12, 15, 12, 15, 12, 15, 12, 15, 12, 15, 12, 15],
        [ 15, 12, 15, 12, 15, 12, 15, 12, 15, 12, 15, 12, 26, 12, 15, 12, 15],
        [ 15, 12, 12, 12, 15, 12, 15, 12, 12, 12, 15, 12, 15, 12, 12, 12, 15],
        [ 15, 15, 15, 15, 15, 15, 15, 26, 26, 26, 15, 15, 15, 15, 15, 15, 15],
        [103,103,103,103,103,103,103,103,103,103,103,103,103,103,103,103,103]
    ],
    "numberOfRows": 13,
    "numberOfColumns": 17
}
]

